00000000000000000000000000
03331112300111111300133330
00121001110123313131000310
01113333012013131331112300
01331021100023113133111010
01101000213013203131111000
03331111233031313133331110
01113011131033113303333110
01123311133111013301133100
03333311033311303301123330
00000000000000000000000000