00000000000000000000000000
01333131131130103131011130
03110100311010133110311010
01111131100330001011001010
01301300333333033311110310
00113103100031100100110110
01000310000333131030311310
00031011301010011330310300
01003031300030311001331010
03311001110131010030110330
00000000000000000000000000