00000000000000000000000000
03333333322333311333333330
03010101033110000000000010
03010101011010101101011010
03330101013103103013133330
03220133013333012133333330
03333301033332233101033310
03333013013033333011010100
01111111120033333333333030
03333332222212333333333330
00000000000000000000000000